..............................
..............................
..............................
..#........E..................
..###.....###.................
......#######.................
............####..............
..................###.........
.....###......................
######################........
..........................####
..............................
..............................
..............................
##############################
